#E#############################
# ###      ####################
# ### #### ####################
# ### #### ####################
#     ####            #########
# ####     ####################
##    #### ####################
########## ####################
###        ####       #########
### ########### ##### #########
###             #####         #
#############################S#