##################################E#######################################
##                    ############ ##                                   ##
## ##################              ## ################################# ##
## #######        ################### ################################# ##
##         ###### #                                            ######## ##
################# # ################################################### ##
###               # ################################################### ##
##### ############# ####                                                 #
##### ##            ##### ############################################# ##
##### ## ################ ##                            ##          ### ##
##### ## ################ ########## ########## ########## ######## ######
##### ## ################            ########## ########## ######## ######
##### ## ################ #####################               ##### ######
#####        ############ ######################################### ######
###################################################################S######